term	pos	category	emotion
jollity	NOUN	Joy	Positive
joviality	NOUN	Joy	Positive
chaff	VERB	Joy	Positive
kid	VERB	Joy	Positive
banter	VERB	Joy	Positive
jolly	VERB	Joy	Positive
merry	ADJ	Joy	Positive
jovial	ADJ	Joy	Positive
jolly	ADJ	Joy	Positive
jocund	ADJ	Joy	Positive
gay	ADJ	Joy	Positive
mirthful	ADJ	Joy	Positive
riotously	ADV	Joy	Positive
exuberantly	ADV	Joy	Positive
expansively	ADV	Joy	Positive
ebulliently	ADV	Joy	Positive
exuberance	NOUN	Joy	Positive
lightheartedness	NOUN	Joy	Positive
carefreeness	NOUN	Joy	Positive
lightsomeness	NOUN	Joy	Positive
insouciance	NOUN	Joy	Positive
unworried	ADJ	Joy	Positive
carefree	ADJ	Joy	Positive
euphoria	NOUN	Joy	Positive
happy	ADJ	Joy	Positive
euphoric	ADJ	Joy	Positive
euphoriant	ADJ	Joy	Positive
content	ADJ	Joy	Positive
contented	ADJ	Joy	Positive
content	VERB	Joy	Positive
contentment	NOUN	Joy	Positive
titillated	ADJ	Joy	Positive
teased	ADJ	Joy	Positive
tickle	VERB	Joy	Positive
titillate	VERB	Joy	Positive
titillating	ADJ	Joy	Positive
titillation	NOUN	Joy	Positive
near	ADV	Joy	Positive
close	ADV	Joy	Positive
nigh	ADV	Joy	Positive
closeness	NOUN	Joy	Positive
intimacy	NOUN	Joy	Positive
close	ADJ	Joy	Positive
smug	ADJ	Joy	Positive
self-satisfied	ADJ	Joy	Positive
smugness	NOUN	Joy	Positive
gala	ADJ	Joy	Positive
festal	ADJ	Joy	Positive
festive	ADJ	Joy	Positive
merriment	NOUN	Joy	Positive
gaiety	NOUN	Joy	Positive
sunny	ADJ	Joy	Positive
cheery	ADJ	Joy	Positive
belonging	NOUN	Joy	Positive
buoyancy	NOUN	Joy	Positive
perkiness	NOUN	Joy	Positive
fulfill	VERB	Joy	Positive
satisfy	VERB	Joy	Positive
fulfil	VERB	Joy	Positive
fulfillment	NOUN	Joy	Positive
fulfilment	NOUN	Joy	Positive
screaming	ADJ	Joy	Positive
uproarious	ADJ	Joy	Positive
hilarious	ADJ	Joy	Positive
gleefulness	NOUN	Joy	Positive
hilarity	NOUN	Joy	Positive
mirthfulness	NOUN	Joy	Positive
mirth	NOUN	Joy	Positive
glee	NOUN	Joy	Positive
uproariously	ADV	Joy	Positive
hilariously	ADV	Joy	Positive
pride	NOUN	Joy	Positive
proudly	ADV	Joy	Positive
triumphal	ADJ	Joy	Positive
prideful	ADJ	Joy	Positive
exulting	ADJ	Joy	Positive
exultant	ADJ	Joy	Positive
rejoicing	ADJ	Joy	Positive
triumphant	ADJ	Joy	Positive
jubilant	ADJ	Joy	Positive
pride	VERB	Joy	Positive
preen	VERB	Joy	Positive
congratulate	VERB	Joy	Positive
elated	ADJ	Joy	Positive
elation	NOUN	Joy	Positive
elate	VERB	Joy	Positive
intoxicate	VERB	Joy	Positive
uplift	VERB	Joy	Positive
exhilarating	ADJ	Joy	Positive
elating	ADJ	Joy	Positive
joyful	ADJ	Joy	Positive
gleeful	ADJ	Joy	Positive
jubilance	NOUN	Joy	Positive
jubilation	NOUN	Joy	Positive
jubilancy	NOUN	Joy	Positive
exultation	NOUN	Joy	Positive
exult	VERB	Joy	Positive
jubilate	VERB	Joy	Positive
triumph	VERB	Joy	Positive
rejoice	VERB	Joy	Positive
exultantly	ADV	Joy	Positive
exultingly	ADV	Joy	Positive
happiness	NOUN	Joy	Positive
blithely	ADV	Joy	Positive
mirthfully	ADV	Joy	Positive
merrily	ADV	Joy	Positive
happily	ADV	Joy	Positive
gayly	ADV	Joy	Positive
jubilantly	ADV	Joy	Positive
pleased	ADJ	Joy	Positive
comfortably	ADV	Joy	Positive
comfortable	ADJ	Joy	Positive
comfortableness	NOUN	Joy	Positive
soothe	VERB	Joy	Positive
comfort	VERB	Joy	Positive
console	VERB	Joy	Positive
solace	VERB	Joy	Positive
satisfaction	NOUN	Joy	Positive
satisfactorily	ADV	Joy	Positive
gratifyingly	ADV	Joy	Positive
satisfyingly	ADV	Joy	Positive
satisfactory	ADJ	Joy	Positive
gratify	VERB	Joy	Positive
comforting	ADJ	Joy	Positive
cheering	ADJ	Joy	Positive
satisfying	ADJ	Joy	Positive
satiable	ADJ	Joy	Positive
satisfiable	ADJ	Joy	Positive
satisfied	ADJ	Joy	Positive
gratifying	ADJ	Joy	Positive
appreciated	ADJ	Joy	Positive
pleasing	ADJ	Joy	Positive
self-complacency	NOUN	Joy	Positive
complacence	NOUN	Joy	Positive
self-satisfaction	NOUN	Joy	Positive
complacency	NOUN	Joy	Positive
complacent	ADJ	Joy	Positive
schadenfreude	NOUN	Joy	Positive
gloat	NOUN	Joy	Positive
gloating	NOUN	Joy	Positive
gloatingly	ADV	Joy	Positive
stimulating	ADJ	Joy	Positive
exhilarate	VERB	Joy	Positive
exalt	VERB	Joy	Positive
thrill	VERB	Joy	Positive
exhilaration	NOUN	Joy	Positive
excitement	NOUN	Joy	Positive
exhilarated	ADJ	Joy	Positive
gladdened	ADJ	Joy	Positive
togetherness	NOUN	Joy	Positive
revel	VERB	Joy	Positive
wallow	VERB	Joy	Positive
triumphantly	ADV	Joy	Positive
triumph	NOUN	Joy	Positive
gladden	VERB	Joy	Positive
joy	VERB	Joy	Positive
joyous	ADJ	Joy	Positive
joy	NOUN	Joy	Positive
joyfulness	NOUN	Joy	Positive
joyousness	NOUN	Joy	Positive
joyfully	ADV	Joy	Positive
gleefully	ADV	Joy	Positive
joyously	ADV	Joy	Positive
glad	ADJ	Joy	Positive
beaming	ADJ	Joy	Positive
gladsome	ADJ	Joy	Positive
gladsomeness	NOUN	Joy	Positive
gladness	NOUN	Joy	Positive
gladfulness	NOUN	Joy	Positive
rush	NOUN	Joy	Positive
thrill	NOUN	Joy	Positive
kick	NOUN	Joy	Positive
flush	NOUN	Joy	Positive
bang	NOUN	Joy	Positive
charge	NOUN	Joy	Positive
rejoicing	NOUN	Joy	Positive
bonheur	NOUN	Joy	Positive
jocularity	NOUN	Joy	Positive
jocundity	NOUN	Joy	Positive
cheer	VERB	Joy	Positive
cheerful	ADJ	Joy	Positive
cheerfully	ADV	Joy	Positive
recreate	VERB	Joy	Positive
hearten	VERB	Joy	Positive
embolden	VERB	Joy	Positive
urge	VERB	Joy	Positive
exhort	VERB	Joy	Positive
inspire	VERB	Joy	Positive
barrack	VERB	Joy	Positive
blitheness	NOUN	Joy	Positive
cheerfulness	NOUN	Joy	Positive
benevolently	ADV	Love	Positive
benevolence	NOUN	Love	Positive
benevolent	ADJ	Love	Positive
good	ADJ	Love	Positive
ardor	NOUN	Love	Positive
ardour	NOUN	Love	Positive
devoted	ADJ	Love	Positive
devotedness	NOUN	Love	Positive
devotion	NOUN	Love	Positive
amorous	ADJ	Love	Positive
romantic	ADJ	Love	Positive
amatory	ADJ	Love	Positive
enamoredness	NOUN	Love	Positive
amorousness	NOUN	Love	Positive
amative	ADJ	Love	Positive
loyalty	NOUN	Love	Positive
lovingness	NOUN	Love	Positive
caring	NOUN	Love	Positive
worshipful	ADJ	Love	Positive
adoring	ADJ	Love	Positive
worship	NOUN	Love	Positive
adoration	NOUN	Love	Positive
love	VERB	Love	Positive
lovingly	ADV	Love	Positive
fondly	ADV	Love	Positive
love	NOUN	Love	Positive
enjoy	VERB	Love	Positive
loving	ADJ	Love	Positive
endearingly	ADV	Love	Positive
adorably	ADV	Love	Positive
benefic	ADJ	Love	Positive
beneficially	ADV	Love	Positive
beneficence	NOUN	Love	Positive
beneficed	ADJ	Love	Positive
beneficent	ADJ	Love	Positive
crush	NOUN	Love	Positive
infatuation	NOUN	Love	Positive
warmth	NOUN	Love	Positive
warmheartedness	NOUN	Love	Positive
warmhearted	ADJ	Love	Positive
affect	VERB	Affection	Positive
move	VERB	Affection	Positive
strike	VERB	Affection	Positive
impress	VERB	Affection	Positive
affection	NOUN	Affection	Positive
heart	NOUN	Affection	Positive
affectionateness	NOUN	Affection	Positive
fondness	NOUN	Affection	Positive
tenderness	NOUN	Affection	Positive
warmheartedness	NOUN	Affection	Positive
affective	ADJ	Affection	Positive
emotive	ADJ	Affection	Positive
affectional	ADJ	Affection	Positive
respect	NOUN	Affection	Positive
regard	NOUN	Affection	Positive
protective	ADJ	Affection	Positive
caring	ADJ	Affection	Positive
protectiveness	NOUN	Affection	Positive
protectively	ADV	Affection	Positive
attachment	NOUN	Affection	Positive
liking	NOUN	Liking	Positive
like	VERB	Liking	Positive
likeable	ADJ	Liking	Positive
likable	ADJ	Liking	Positive
goodwill	NOUN	Liking	Positive
compatibly	ADV	Liking	Positive
sympathetic	ADJ	Liking	Positive
compatible	ADJ	Liking	Positive
rapport	NOUN	Liking	Positive
compatibility	NOUN	Liking	Positive
tenderness	NOUN	Liking	Positive
softheartedness	NOUN	Liking	Positive
softhearted	ADJ	Liking	Positive
soft-boiled	ADJ	Liking	Positive
identify	VERB	Liking	Positive
identification	NOUN	Liking	Positive
favour	NOUN	Liking	Positive
favor	NOUN	Liking	Positive
favour	VERB	Liking	Positive
favor	VERB	Liking	Positive
favorable	ADJ	Liking	Positive
favourable	ADJ	Liking	Positive
favorably	ADV	Liking	Positive
favourably	ADV	Liking	Positive
admiration	NOUN	Liking	Positive
esteem	NOUN	Liking	Positive
admirable	ADJ	Liking	Positive
admirably	ADV	Liking	Positive
laudably	ADV	Liking	Positive
praiseworthily	ADV	Liking	Positive
commendable	ADV	Liking	Positive
admire	VERB	Liking	Positive
weakness	NOUN	Liking	Positive
fraternal	ADJ	Liking	Positive
brotherly	ADJ	Liking	Positive
brotherlike	ADJ	Liking	Positive
brotherhood	NOUN	Liking	Positive
kindhearted	ADJ	Liking	Positive
kindheartedness	NOUN	Liking	Positive
approval	NOUN	Liking	Positive
approbatory	ADJ	Liking	Positive
approving	ADJ	Liking	Positive
approbative	ADJ	Liking	Positive
approve	VERB	Liking	Positive
approved	ADJ	Liking	Positive
amicably	ADV	Liking	Positive
amicable	ADJ	Liking	Positive
amicability	NOUN	Liking	Positive
amicableness	NOUN	Liking	Positive
interest	VERB	Liking	Positive
occupy	VERB	Liking	Positive
concern	VERB	Liking	Positive
worry	VERB	Liking	Positive
concern	NOUN	Liking	Positive
friendly	ADJ	Liking	Positive
friendliness	NOUN	Liking	Positive
lovesome	ADJ	Liking	Positive
caring	ADJ	Liking	Positive
tender	ADJ	Liking	Positive
warm	ADJ	Liking	Positive
fond	ADJ	Liking	Positive
affectionate	ADJ	Liking	Positive
fancy	NOUN	Liking	Positive
partiality	NOUN	Liking	Positive
fondness	NOUN	Liking	Positive
preference	NOUN	Liking	Positive
predilection	NOUN	Liking	Positive
taste	NOUN	Liking	Positive
penchant	NOUN	Liking	Positive
sympathetically	ADV	Liking	Positive
empathetically	ADV	Liking	Positive
kindly	ADJ	Liking	Positive
charitable	ADJ	Liking	Positive
sympathy	NOUN	Liking	Positive
fascination	NOUN	Liking	Positive
captivation	NOUN	Liking	Positive
enchantment	NOUN	Liking	Positive
enthrallment	NOUN	Liking	Positive
captivated	ADJ	Liking	Positive
charmed	ADJ	Liking	Positive
trance	VERB	Liking	Positive
entrance	VERB	Liking	Positive
charm	VERB	Liking	Positive
enchant	VERB	Liking	Positive
capture	VERB	Liking	Positive
beguile	VERB	Liking	Positive
captivate	VERB	Liking	Positive
enamour	VERB	Liking	Positive
bewitch	VERB	Liking	Positive
fascinate	VERB	Liking	Positive
becharm	VERB	Liking	Positive
catch	VERB	Liking	Positive
enamor	VERB	Liking	Positive
fascinating	ADJ	Liking	Positive
enthralling	ADJ	Liking	Positive
captivating	ADJ	Liking	Positive
entrancing	ADJ	Liking	Positive
bewitching	ADJ	Liking	Positive
enchanting	ADJ	Liking	Positive
enthralled	ADJ	Liking	Positive
delighted	ADJ	Liking	Positive
entranced	ADJ	Liking	Positive
beguiled	ADJ	Liking	Positive
empathetic	ADJ	Liking	Positive
empathic	ADJ	Liking	Positive
empathy	NOUN	Liking	Positive
relish	NOUN	Enthusiasm	Positive
zest	NOUN	Enthusiasm	Positive
zestfulness	NOUN	Enthusiasm	Positive
gusto	NOUN	Enthusiasm	Positive
enthusiastically	ADV	Enthusiasm	Positive
exciting	ADJ	Enthusiasm	Positive
enthusiasm	NOUN	Enthusiasm	Positive
enthusiastic	ADJ	Enthusiasm	Positive
riotously	ADV	Enthusiasm	Positive
exuberantly	ADV	Enthusiasm	Positive
expansively	ADV	Enthusiasm	Positive
ebulliently	ADV	Enthusiasm	Positive
exuberance	NOUN	Enthusiasm	Positive
eagerly	ADV	Enthusiasm	Positive
thirstily	ADV	Enthusiasm	Positive
keenness	NOUN	Enthusiasm	Positive
eagerness	NOUN	Enthusiasm	Positive
avidity	NOUN	Enthusiasm	Positive
avidness	NOUN	Enthusiasm	Positive
eager	ADJ	Enthusiasm	Positive
zealous	ADJ	Enthusiasm	Positive
great	ADJ	Enthusiasm	Positive
avid	ADJ	Enthusiasm	Positive
zeal	NOUN	Enthusiasm	Positive
ardor	NOUN	Enthusiasm	Positive
elan	NOUN	Enthusiasm	Positive
ardour	NOUN	Enthusiasm	Positive
appreciatively	ADV	Gratitude	Positive
gratefully	ADV	Gratitude	Positive
gratitude	NOUN	Gratitude	Positive
thankful	ADJ	Gratitude	Positive
grateful	ADJ	Gratitude	Positive
appreciativeness	NOUN	Gratitude	Positive
thankfulness	NOUN	Gratitude	Positive
gratefulness	NOUN	Gratitude	Positive
ego	NOUN	Pride	Positive
egotism	NOUN	Pride	Positive
self-importance	NOUN	Pride	Positive
vanity	NOUN	Pride	Positive
self-love	NOUN	Pride	Positive
conceit	NOUN	Pride	Positive
pridefulness	NOUN	Pride	Positive
pride	NOUN	Pride	Positive
pride	VERB	Pride	Positive
congratulate	VERB	Pride	Positive
plume	VERB	Pride	Positive
proudly	ADV	Pride	Positive
triumphal	ADJ	Pride	Positive
prideful	ADJ	Pride	Positive
exulting	ADJ	Pride	Positive
exultant	ADJ	Pride	Positive
rejoicing	ADJ	Pride	Positive
triumphant	ADJ	Pride	Positive
jubilant	ADJ	Pride	Positive
proud	ADJ	Pride	Positive
self-pride	NOUN	Pride	Positive
self-esteem	NOUN	Pride	Positive
levity	NOUN	Levity	Positive
merry	ADJ	Levity	Positive
gala	ADJ	Levity	Positive
festal	ADJ	Levity	Positive
gay	ADJ	Levity	Positive
festive	ADJ	Levity	Positive
sunny	ADJ	Levity	Positive
cheery	ADJ	Levity	Positive
gaiety	NOUN	Levity	Positive
playfulness	NOUN	Levity	Positive
jovial	ADJ	Levity	Positive
jolly	ADJ	Levity	Positive
jocund	ADJ	Levity	Positive
mirthful	ADJ	Levity	Positive
calmness	NOUN	Calmness	Positive
serene	ADJ	Calmness	Positive
calm	ADJ	Calmness	Positive
tranquil	ADJ	Calmness	Positive
quiet	VERB	Calmness	Positive
tranquillize	VERB	Calmness	Positive
lull	VERB	Calmness	Positive
still	VERB	Calmness	Positive
tranquilize	VERB	Calmness	Positive
quieten	VERB	Calmness	Positive
calm	VERB	Calmness	Positive
calming	ADJ	Calmness	Positive
quietening	ADJ	Calmness	Positive
lulling	ADJ	Calmness	Positive
calmly	ADV	Calmness	Positive
assuasive	ADJ	Calmness	Positive
pacifying	ADJ	Calmness	Positive
soothing	ADJ	Calmness	Positive
peaceably	ADV	Calmness	Positive
pacifically	ADV	Calmness	Positive
peace-loving	ADJ	Calmness	Positive
peaceable	ADJ	Calmness	Positive
heartsease	NOUN	Calmness	Positive
peace	NOUN	Calmness	Positive
ataraxis	NOUN	Calmness	Positive
peacefulness	NOUN	Calmness	Positive
serenity	NOUN	Calmness	Positive
repose	NOUN	Calmness	Positive
imperturbability	NOUN	Calmness	Positive
coolness	NOUN	Calmness	Positive
phlegm	NOUN	Calmness	Positive
imperturbableness	NOUN	Calmness	Positive
cool	VERB	Calmness	Positive
chill	VERB	Calmness	Positive
cool	ADJ	Calmness	Positive
cold	ADJ	Calmness	Positive
tranquilly	ADV	Calmness	Positive
unagitated	ADJ	Calmness	Positive
tranquillity	NOUN	Calmness	Positive
quietude	NOUN	Calmness	Positive
tranquility	NOUN	Calmness	Positive
quietness	NOUN	Calmness	Positive
languid	ADJ	Calmness	Positive
languorous	ADJ	Calmness	Positive
dreamy	ADJ	Calmness	Positive
lackadaisical	ADJ	Calmness	Positive
dreaminess	NOUN	Calmness	Positive
languor	NOUN	Calmness	Positive
languorously	ADV	Calmness	Positive
easy	ADV	Calmness	Positive
easily	ADV	Calmness	Positive
easiness	NOUN	Calmness	Positive
relaxation	NOUN	Calmness	Positive
allay	VERB	Calmness	Positive
relieve	VERB	Calmness	Positive
ease	VERB	Calmness	Positive
easy	ADJ	Calmness	Positive
placidity	NOUN	Calmness	Positive
placidness	NOUN	Calmness	Positive
quiet	ADJ	Calmness	Positive
unruffled	ADJ	Calmness	Positive
still	ADJ	Calmness	Positive
placid	ADJ	Calmness	Positive
placidly	ADV	Calmness	Positive
reassured	ADJ	Fearlessness	Positive
reassuring	ADJ	Fearlessness	Positive
reassure	VERB	Fearlessness	Positive
assure	VERB	Fearlessness	Positive
security	NOUN	Fearlessness	Positive
reassuringly	ADV	Fearlessness	Positive
confidence	NOUN	Fearlessness	Positive
positive	ADJ	Fearlessness	Positive
convinced	ADJ	Fearlessness	Positive
confident	ADJ	Fearlessness	Positive
dauntlessly	ADV	Fearlessness	Positive
fearlessly	ADV	Fearlessness	Positive
intrepidly	ADV	Fearlessness	Positive
bravery	NOUN	Fearlessness	Positive
fearlessness	NOUN	Fearlessness	Positive
unafraid	ADJ	Fearlessness	Positive
fearless	ADJ	Fearlessness	Positive
hardy	ADJ	Fearlessness	Positive
doughty	ADJ	Fearlessness	Positive
suspense	NOUN	Expectation	Positive
suspensive	ADJ	Expectation	Positive
cliff-hanging	ADJ	Expectation	Positive
suspenseful	ADJ	Expectation	Positive
expectancy	NOUN	Expectation	Positive
anticipation	NOUN	Expectation	Positive
anticipate	VERB	Expectation	Positive
frisson	NOUN	Fear	Positive
chill	NOUN	Fear	Positive
shudder	NOUN	Fear	Positive
thrill	NOUN	Fear	Positive
quiver	NOUN	Fear	Positive
tingle	NOUN	Fear	Positive
shiver	NOUN	Fear	Positive
hopeful	ADJ	Hope	Positive
hopefully	ADV	Hope	Positive
hopefulness	NOUN	Hope	Positive
hope	VERB	Hope	Positive
encouragingly	ADV	Hope	Positive
encourage	VERB	Hope	Positive
encouragement	NOUN	Hope	Positive
encouraging	ADJ	Hope	Positive
encouraged	ADJ	Hope	Positive
sanguinity	NOUN	Hope	Positive
sanguineness	NOUN	Hope	Positive
sanguine	ADJ	Hope	Positive
hope	NOUN	Hope	Positive
optimistic	ADJ	Hope	Positive
optimism	NOUN	Hope	Positive
optimistically	ADV	Hope	Positive
suspense	NOUN	Fear	Negative
suspensive	ADJ	Fear	Negative
cliff-hanging	ADJ	Fear	Negative
suspenseful	ADJ	Fear	Negative
hangdog	ADJ	Fear	Negative
cowed	ADJ	Fear	Negative
intimidated	ADJ	Fear	Negative
browbeaten	ADJ	Fear	Negative
bullied	ADJ	Fear	Negative
intimidate	VERB	Fear	Negative
intimidation	NOUN	Fear	Negative
consternation	NOUN	Fear	Negative
alarm	NOUN	Fear	Negative
dismay	NOUN	Fear	Negative
alarm	VERB	Fear	Negative
dismay	VERB	Fear	Negative
appall	VERB	Fear	Negative
appal	VERB	Fear	Negative
horrify	VERB	Fear	Negative
alert	VERB	Fear	Negative
alarmed	ADJ	Fear	Negative
apprehensive	ADJ	Fear	Negative
anxious	ADJ	Fear	Negative
anxiously	ADV	Fear	Negative
uneasily	ADV	Fear	Negative
apprehensively	ADV	Fear	Negative
dread	NOUN	Fear	Negative
apprehension	NOUN	Fear	Negative
apprehensiveness	NOUN	Fear	Negative
hysterically	ADV	Fear	Negative
hysteria	NOUN	Fear	Negative
hysterical	ADJ	Fear	Negative
shadow	NOUN	Fear	Negative
afraid	ADJ	Fear	Negative
terrible	ADJ	Fear	Negative
fearful	ADJ	Fear	Negative
frightful	ADJ	Fear	Negative
fear	VERB	Fear	Negative
dreaded	ADJ	Fear	Negative
dire	ADJ	Fear	Negative
frightening	ADJ	Fear	Negative
direful	ADJ	Fear	Negative
fearsome	ADJ	Fear	Negative
dreadful	ADJ	Fear	Negative
horrendous	ADJ	Fear	Negative
horrific	ADJ	Fear	Negative
awful	ADJ	Fear	Negative
dread	ADJ	Fear	Negative
dread	VERB	Fear	Negative
fearfully	ADV	Fear	Negative
fearfulness	NOUN	Fear	Negative
fright	NOUN	Fear	Negative
fear	NOUN	Fear	Negative
creeps	NOUN	Fear	Negative
fawn	VERB	Fear	Negative
crawl	VERB	Fear	Negative
cringe	VERB	Fear	Negative
grovel	VERB	Fear	Negative
creep	VERB	Fear	Negative
cower	VERB	Fear	Negative
heartless	ADJ	Fear	Negative
hardhearted	ADJ	Fear	Negative
coldheartedness	NOUN	Fear	Negative
hardheartedness	NOUN	Fear	Negative
heartlessness	NOUN	Fear	Negative
heartlessly	ADV	Fear	Negative
fright	VERB	Fear	Negative
scare	VERB	Fear	Negative
affright	VERB	Fear	Negative
frighten	VERB	Fear	Negative
dash	VERB	Fear	Negative
pall	VERB	Fear	Negative
daunt	VERB	Fear	Negative
scared	ADJ	Fear	Negative
frightened	ADJ	Fear	Negative
scarily	ADV	Fear	Negative
frighteningly	ADV	Fear	Negative
shuddery	ADJ	Fear	Negative
shivery	ADJ	Fear	Negative
scary	ADJ	Fear	Negative
scarey	ADJ	Fear	Negative
chilling	ADJ	Fear	Negative
scare	NOUN	Fear	Negative
presage	NOUN	Fear	Negative
chill	NOUN	Fear	Negative
pall	NOUN	Fear	Negative
chill	VERB	Fear	Negative
shy	ADJ	Fear	Negative
shyness	NOUN	Fear	Negative
diffident	ADJ	Fear	Negative
unsure	ADJ	Fear	Negative
timid	ADJ	Fear	Negative
unassertiveness	NOUN	Fear	Negative
unassertively	ADV	Fear	Negative
unassertive	ADJ	Fear	Negative
panic	NOUN	Fear	Negative
terror	NOUN	Fear	Negative
panic-stricken	ADJ	Fear	Negative
panicked	ADJ	Fear	Negative
panic-struck	ADJ	Fear	Negative
terrified	ADJ	Fear	Negative
panicky	ADJ	Fear	Negative
panic	VERB	Fear	Negative
hesitance	NOUN	Fear	Negative
hesitancy	NOUN	Fear	Negative
hesitatingly	ADV	Fear	Negative
hesitantly	ADV	Fear	Negative
trepidation	NOUN	Fear	Negative
timorously	ADV	Fear	Negative
trepidly	ADV	Fear	Negative
timorous	ADJ	Fear	Negative
trepid	ADJ	Fear	Negative
diffidently	ADV	Fear	Negative
self-doubt	NOUN	Fear	Negative
diffidence	NOUN	Fear	Negative
self-distrust	NOUN	Fear	Negative
foreboding	NOUN	Fear	Negative
boding	NOUN	Fear	Negative
presentiment	NOUN	Fear	Negative
premonition	NOUN	Fear	Negative
horrified	ADJ	Fear	Negative
horror-struck	ADJ	Fear	Negative
horror-stricken	ADJ	Fear	Negative
horrifyingly	ADV	Fear	Negative
hideously	ADV	Fear	Negative
horridly	ADV	Fear	Negative
monstrously	ADV	Fear	Negative
hideous	ADJ	Fear	Negative
horrid	ADJ	Fear	Negative
outrageous	ADJ	Fear	Negative
awfully	ADV	Fear	Negative
horribly	ADV	Fear	Negative
dreadfully	ADV	Fear	Negative
horror	NOUN	Fear	Negative
atrocious	ADJ	Fear	Negative
horrible	ADJ	Fear	Negative
ugly	ADJ	Fear	Negative
horrifying	ADJ	Fear	Negative
cruel	ADJ	Fear	Negative
unkind	ADJ	Fear	Negative
ruthlessness	NOUN	Fear	Negative
mercilessness	NOUN	Fear	Negative
cruelty	NOUN	Fear	Negative
pitilessness	NOUN	Fear	Negative
cruelly	ADV	Fear	Negative
timidly	ADV	Fear	Negative
shyly	ADV	Fear	Negative
bashfully	ADV	Fear	Negative
timidness	NOUN	Fear	Negative
timidity	NOUN	Fear	Negative
timorousness	NOUN	Fear	Negative
harass	VERB	Sadness	Negative
oppress	VERB	Sadness	Negative
persecute	VERB	Sadness	Negative
oppressively	ADV	Sadness	Negative
tyrannous	ADJ	Sadness	Negative
oppressive	ADJ	Sadness	Negative
tyrannical	ADJ	Sadness	Negative
laden	ADJ	Sadness	Negative
oppressed	ADJ	Sadness	Negative
oppression	NOUN	Sadness	Negative
oppressiveness	NOUN	Sadness	Negative
downtrodden	ADJ	Sadness	Negative
persecuted	ADJ	Sadness	Negative
despondency	NOUN	Sadness	Negative
despondence	NOUN	Sadness	Negative
heartsickness	NOUN	Sadness	Negative
disconsolateness	NOUN	Sadness	Negative
heartsick	ADJ	Sadness	Negative
despondent	ADJ	Sadness	Negative
despairingly	ADV	Sadness	Negative
despondently	ADV	Sadness	Negative
compunction	NOUN	Sadness	Negative
self-reproach	NOUN	Sadness	Negative
remorse	NOUN	Sadness	Negative
lorn	ADJ	Sadness	Negative
forlorn	ADJ	Sadness	Negative
godforsaken	ADJ	Sadness	Negative
desolate	ADJ	Sadness	Negative
desolation	NOUN	Sadness	Negative
forlornness	NOUN	Sadness	Negative
loneliness	NOUN	Sadness	Negative
forlornly	ADV	Sadness	Negative
heavyheartedness	NOUN	Sadness	Negative
heavyhearted	ADJ	Sadness	Negative
joylessness	NOUN	Sadness	Negative
joylessly	ADV	Sadness	Negative
joyless	ADJ	Sadness	Negative
plaintive	ADJ	Sadness	Negative
mournful	ADJ	Sadness	Negative
mournfully	ADV	Sadness	Negative
ruthfulness	NOUN	Sadness	Negative
mournfulness	NOUN	Sadness	Negative
sorrowfulness	NOUN	Sadness	Negative
doleful	ADJ	Sadness	Negative
dolorous	ADJ	Sadness	Negative
weeping	ADJ	Sadness	Negative
lachrymose	ADJ	Sadness	Negative
tearful	ADJ	Sadness	Negative
dolourous	ADJ	Sadness	Negative
weepiness	NOUN	Sadness	Negative
tearfulness	NOUN	Sadness	Negative
down	ADJ	Sadness	Negative
low-spirited	ADJ	Sadness	Negative
dispirited	ADJ	Sadness	Negative
downcast	ADJ	Sadness	Negative
blue	ADJ	Sadness	Negative
depressed	ADJ	Sadness	Negative
low	ADJ	Sadness	Negative
downhearted	ADJ	Sadness	Negative
dispiritedness	NOUN	Sadness	Negative
downheartedness	NOUN	Sadness	Negative
low-spiritedness	NOUN	Sadness	Negative
unhappy	ADJ	Sadness	Negative
sad	ADJ	Sadness	Negative
unhappiness	NOUN	Sadness	Negative
sadness	NOUN	Sadness	Negative
sadden	VERB	Sadness	Negative
sad	VERB	Sadness	Negative
sadly	ADV	Sadness	Negative
lamentably	ADV	Sadness	Negative
woefully	ADV	Sadness	Negative
deplorably	ADV	Sadness	Negative
dysphoria	NOUN	Sadness	Negative
dysphoric	ADJ	Sadness	Negative
distressed	ADJ	Sadness	Negative
ruefully	ADV	Sadness	Negative
contritely	ADV	Sadness	Negative
remorsefully	ADV	Sadness	Negative
attrition	NOUN	Sadness	Negative
contrition	NOUN	Sadness	Negative
contriteness	NOUN	Sadness	Negative
contrite	ADJ	Sadness	Negative
sorry	ADJ	Sadness	Negative
remorseful	ADJ	Sadness	Negative
rueful	ADJ	Sadness	Negative
repent	VERB	Sadness	Negative
regret	VERB	Sadness	Negative
rue	VERB	Sadness	Negative
penance	NOUN	Sadness	Negative
repentance	NOUN	Sadness	Negative
penitence	NOUN	Sadness	Negative
penitentially	ADV	Sadness	Negative
repentantly	ADV	Sadness	Negative
penitently	ADV	Sadness	Negative
repentant	ADJ	Sadness	Negative
penitent	ADJ	Sadness	Negative
weltschmerz	NOUN	Sadness	Negative
world-weariness	NOUN	Sadness	Negative
world-weary	ADJ	Sadness	Negative
bored	ADJ	Sadness	Negative
misery	NOUN	Sadness	Negative
miserably	ADV	Sadness	Negative
suffering	ADJ	Sadness	Negative
miserable	ADJ	Sadness	Negative
wretched	ADJ	Sadness	Negative
hapless	ADJ	Sadness	Negative
pitiable	ADJ	Sadness	Negative
poor	ADJ	Sadness	Negative
misfortunate	ADJ	Sadness	Negative
pathetic	ADJ	Sadness	Negative
pitiful	ADJ	Sadness	Negative
piteous	ADJ	Sadness	Negative
dolour	NOUN	Sadness	Negative
dolor	NOUN	Sadness	Negative
depression	NOUN	Sadness	Negative
gloomy	ADJ	Sadness	Negative
depressing	ADJ	Sadness	Negative
depressive	ADJ	Sadness	Negative
saddening	ADJ	Sadness	Negative
deject	VERB	Sadness	Negative
demoralize	VERB	Sadness	Negative
dismay	VERB	Sadness	Negative
depress	VERB	Sadness	Negative
dispirit	VERB	Sadness	Negative
grievous	ADJ	Sadness	Negative
heartbreaking	ADJ	Sadness	Negative
heartrending	ADJ	Sadness	Negative
grievously	ADV	Sadness	Negative
grief-stricken	ADJ	Sadness	Negative
bereaved	ADJ	Sadness	Negative
mourning	ADJ	Sadness	Negative
grieving	ADJ	Sadness	Negative
bereft	ADJ	Sadness	Negative
sorrowing	ADJ	Sadness	Negative
sorrow	VERB	Sadness	Negative
grieve	VERB	Sadness	Negative
aggrieve	VERB	Sadness	Negative
heartache	NOUN	Sadness	Negative
brokenheartedness	NOUN	Sadness	Negative
grief	NOUN	Sadness	Negative
heartbreak	NOUN	Sadness	Negative
woeful	ADJ	Sadness	Negative
execrable	ADJ	Sadness	Negative
deplorable	ADJ	Sadness	Negative
woefulness	NOUN	Sadness	Negative
woe	NOUN	Sadness	Negative
woebegone	ADJ	Sadness	Negative
dolefulness	NOUN	Sadness	Negative
dolefully	ADV	Sadness	Negative
sorrowfully	ADV	Sadness	Negative
helplessness	NOUN	Sadness	Negative
cheerless	ADJ	Sadness	Negative
uncheerful	ADJ	Sadness	Negative
cheerlessly	ADV	Sadness	Negative
cheerlessness	NOUN	Sadness	Negative
uncheerfulness	NOUN	Sadness	Negative
melancholy	NOUN	Sadness	Negative
melancholy	ADJ	Sadness	Negative
melancholic	ADJ	Sadness	Negative
gloom	NOUN	Sadness	Negative
somberness	NOUN	Sadness	Negative
gloominess	NOUN	Sadness	Negative
dark	ADJ	Sadness	Negative
disconsolate	ADJ	Sadness	Negative
dispiriting	ADJ	Sadness	Negative
grim	ADJ	Sadness	Negative
dismal	ADJ	Sadness	Negative
gloomily	ADV	Sadness	Negative
glooming	ADJ	Sadness	Negative
gloomful	ADJ	Sadness	Negative
dingy	ADJ	Sadness	Negative
drab	ADJ	Sadness	Negative
drear	ADJ	Sadness	Negative
dreary	ADJ	Sadness	Negative
glum	ADJ	Sadness	Negative
long-faced	ADJ	Sadness	Negative
self-pity	NOUN	Sadness	Negative
sorrow	NOUN	Sadness	Negative
bad	ADJ	Sadness	Negative
pitying	ADJ	Sadness	Negative
sorrowful	ADJ	Sadness	Negative
guilt	NOUN	Sadness	Negative
hangdog	ADJ	Sadness	Negative
guilty	ADJ	Sadness	Negative
shamefaced	ADJ	Sadness	Negative
shamed	ADJ	Sadness	Negative
weight	NOUN	Sadness	Negative
plaintiveness	NOUN	Sadness	Negative
plaintively	ADV	Sadness	Negative
disheartening	ADJ	Sadness	Negative
demoralising	ADJ	Sadness	Negative
demoralizing	ADJ	Sadness	Negative
demoralization	NOUN	Sadness	Negative
discouraged	ADJ	Sadness	Negative
demoralized	ADJ	Sadness	Negative
disheartened	ADJ	Sadness	Negative
regret	NOUN	Sadness	Negative
ruefulness	NOUN	Sadness	Negative
regretful	ADJ	Sadness	Negative
animosity	NOUN	Dislike	Negative
animus	NOUN	Dislike	Negative
dislikable	ADJ	Dislike	Negative
dislike	VERB	Dislike	Negative
dislike	NOUN	Dislike	Negative
irascibility	NOUN	Dislike	Negative
spleen	NOUN	Dislike	Negative
choleric	ADJ	Dislike	Negative
irascible	ADJ	Dislike	Negative
resentfully	ADV	Dislike	Negative
rancor	NOUN	Dislike	Negative
rancour	NOUN	Dislike	Negative
resentment	NOUN	Dislike	Negative
gall	NOUN	Dislike	Negative
bitterness	NOUN	Dislike	Negative
resentful	ADJ	Dislike	Negative
green-eyed	ADJ	Dislike	Negative
jealous	ADJ	Dislike	Negative
overjealous	ADJ	Dislike	Negative
envious	ADJ	Dislike	Negative
covetous	ADJ	Dislike	Negative
jealously	ADV	Dislike	Negative
jealousy	NOUN	Dislike	Negative
enviously	ADV	Dislike	Negative
covetously	ADV	Dislike	Negative
separated	ADJ	Dislike	Negative
detached	ADJ	Dislike	Negative
set-apart	ADJ	Dislike	Negative
isolated	ADJ	Dislike	Negative
isolation	NOUN	Dislike	Negative
angry	ADJ	Dislike	Negative
anger	VERB	Dislike	Negative
angrily	ADV	Dislike	Negative
anger	NOUN	Dislike	Negative
ire	NOUN	Dislike	Negative
choler	NOUN	Dislike	Negative
maddened	ADJ	Dislike	Negative
infuriated	ADJ	Dislike	Negative
enraged	ADJ	Dislike	Negative
furious	ADJ	Dislike	Negative
angered	ADJ	Dislike	Negative
displease	VERB	Dislike	Negative
displeased	ADJ	Dislike	Negative
displeasingly	ADV	Dislike	Negative
displeasing	ADJ	Dislike	Negative
displeasure	NOUN	Dislike	Negative
lividly	ADV	Dislike	Negative
lividity	NOUN	Dislike	Negative
livid	ADJ	Dislike	Negative
dander	NOUN	Dislike	Negative
hackles	NOUN	Dislike	Negative
hostile	ADJ	Dislike	Negative
hostility	NOUN	Dislike	Negative
enmity	NOUN	Dislike	Negative
hostilely	ADV	Dislike	Negative
belligerently	ADV	Dislike	Negative
torment	NOUN	Dislike	Negative
harassment	NOUN	Dislike	Negative
harass	VERB	Dislike	Negative
oppress	VERB	Dislike	Negative
persecute	VERB	Dislike	Negative
dudgeon	NOUN	Dislike	Negative
repulsively	ADV	Dislike	Negative
abominably	ADV	Dislike	Negative
detestably	ADV	Dislike	Negative
odiously	ADV	Dislike	Negative
detestable	ADJ	Dislike	Negative
repulsive	ADJ	Dislike	Negative
repugnant	ADJ	Dislike	Negative
obscene	ADJ	Dislike	Negative
abhorrent	ADJ	Dislike	Negative
hideous	ADJ	Dislike	Negative
horrid	ADJ	Dislike	Negative
horrific	ADJ	Dislike	Negative
outrageous	ADJ	Dislike	Negative
repulse	VERB	Dislike	Negative
repel	VERB	Dislike	Negative
repulsion	NOUN	Dislike	Negative
horror	NOUN	Dislike	Negative
revulsion	NOUN	Dislike	Negative
repugnance	NOUN	Dislike	Negative
revolt	VERB	Dislike	Negative
disgust	VERB	Dislike	Negative
estrange	VERB	Dislike	Negative
alienate	VERB	Dislike	Negative
disaffect	VERB	Dislike	Negative
alien	VERB	Dislike	Negative
estranged	ADJ	Dislike	Negative
alienated	ADJ	Dislike	Negative
disaffection	NOUN	Dislike	Negative
alienation	NOUN	Dislike	Negative
estrangement	NOUN	Dislike	Negative
disoriented	ADJ	Dislike	Negative
anomic	ADJ	Dislike	Negative
misology	NOUN	Dislike	Negative
misoneism	NOUN	Dislike	Negative
heartburning	NOUN	Dislike	Negative
sulk	VERB	Dislike	Negative
brood	VERB	Dislike	Negative
pout	VERB	Dislike	Negative
sulkiness	NOUN	Dislike	Negative
huffishness	NOUN	Dislike	Negative
sulky	ADJ	Dislike	Negative
huffish	ADJ	Dislike	Negative
stew	VERB	Dislike	Negative
grizzle	VERB	Dislike	Negative
malevolence	NOUN	Dislike	Negative
malignity	NOUN	Dislike	Negative
malevolently	ADV	Dislike	Negative
malevolent	ADJ	Dislike	Negative
malicious	ADJ	Dislike	Negative
maliciously	ADV	Dislike	Negative
venom	NOUN	Dislike	Negative
spite	NOUN	Dislike	Negative
spitefulness	NOUN	Dislike	Negative
malice	NOUN	Dislike	Negative
maliciousness	NOUN	Dislike	Negative
warpath	NOUN	Dislike	Negative
hatefully	ADV	Dislike	Negative
hateful	ADJ	Dislike	Negative
hatred	NOUN	Dislike	Negative
hate	NOUN	Dislike	Negative
detest	VERB	Dislike	Negative
hate	VERB	Dislike	Negative
wrath	NOUN	Dislike	Negative
wrathful	ADJ	Dislike	Negative
wroth	ADJ	Dislike	Negative
wrothful	ADJ	Dislike	Negative
wrathfully	ADV	Dislike	Negative
huffily	ADV	Dislike	Negative
sore	ADJ	Dislike	Negative
mad	ADJ	Dislike	Negative
huffy	ADJ	Dislike	Negative
huffiness	NOUN	Dislike	Negative
afraid	ADJ	Dislike	Negative
antipathy	NOUN	Dislike	Negative
aversion	NOUN	Dislike	Negative
distaste	NOUN	Dislike	Negative
misanthropic	ADJ	Dislike	Negative
misanthropical	ADJ	Dislike	Negative
misanthropy	NOUN	Dislike	Negative
scene	NOUN	Dislike	Negative
tantrum	NOUN	Dislike	Negative
fit	NOUN	Dislike	Negative
loathing	NOUN	Dislike	Negative
abhorrence	NOUN	Dislike	Negative
abomination	NOUN	Dislike	Negative
execration	NOUN	Dislike	Negative
detestation	NOUN	Dislike	Negative
odium	NOUN	Dislike	Negative
loathe	VERB	Dislike	Negative
abominate	VERB	Dislike	Negative
execrate	VERB	Dislike	Negative
abhor	VERB	Dislike	Negative
aggressiveness	NOUN	Dislike	Negative
aggression	NOUN	Dislike	Negative
enviably	ADV	Dislike	Negative
envy	VERB	Dislike	Negative
begrudge	VERB	Dislike	Negative
enviousness	NOUN	Dislike	Negative
envy	NOUN	Dislike	Negative
enviable	ADJ	Dislike	Negative
grudging	ADJ	Dislike	Negative
begrudging	ADJ	Dislike	Negative
disinclined	ADJ	Dislike	Negative
indispose	VERB	Dislike	Negative
disincline	VERB	Dislike	Negative
disinclination	NOUN	Dislike	Negative
misogamy	NOUN	Dislike	Negative
queasy	ADJ	Dislike	Negative
sick	ADJ	Dislike	Negative
nauseated	ADJ	Dislike	Negative
sickish	ADJ	Dislike	Negative
sicken	VERB	Dislike	Negative
nauseate	VERB	Dislike	Negative
noisome	ADJ	Dislike	Negative
nauseating	ADJ	Dislike	Negative
nauseous	ADJ	Dislike	Negative
loathsome	ADJ	Dislike	Negative
sickening	ADJ	Dislike	Negative
offensive	ADJ	Dislike	Negative
vile	ADJ	Dislike	Negative
nausea	NOUN	Dislike	Negative
misogynism	NOUN	Dislike	Negative
misogyny	NOUN	Dislike	Negative
misogynic	ADJ	Dislike	Negative
belligerent	ADJ	Dislike	Negative
aggressive	ADJ	Dislike	Negative
belligerency	NOUN	Dislike	Negative
belligerence	NOUN	Dislike	Negative
annoyance	NOUN	Dislike	Negative
chafe	NOUN	Dislike	Negative
vexation	NOUN	Dislike	Negative
annoyed	ADJ	Dislike	Negative
pestered	ADJ	Dislike	Negative
vexed	ADJ	Dislike	Negative
harassed	ADJ	Dislike	Negative
harried	ADJ	Dislike	Negative
rag	VERB	Dislike	Negative
nettle	VERB	Dislike	Negative
devil	VERB	Dislike	Negative
nark	VERB	Dislike	Negative
annoy	VERB	Dislike	Negative
irritate	VERB	Dislike	Negative
vex	VERB	Dislike	Negative
rile	VERB	Dislike	Negative
gravel	VERB	Dislike	Negative
bother	VERB	Dislike	Negative
pissed	ADJ	Dislike	Negative
roiled	ADJ	Dislike	Negative
riled	ADJ	Dislike	Negative
irritated	ADJ	Dislike	Negative
peeved	ADJ	Dislike	Negative
stung	ADJ	Dislike	Negative
nettled	ADJ	Dislike	Negative
teasing	ADJ	Dislike	Negative
galling	ADJ	Dislike	Negative
annoying	ADJ	Dislike	Negative
vexatious	ADJ	Dislike	Negative
plaguy	ADJ	Dislike	Negative
nettlesome	ADJ	Dislike	Negative
pestering	ADJ	Dislike	Negative
pesky	ADJ	Dislike	Negative
irritating	ADJ	Dislike	Negative
bothersome	ADJ	Dislike	Negative
pestiferous	ADJ	Dislike	Negative
vexing	ADJ	Dislike	Negative
plaguey	ADJ	Dislike	Negative
exasperate	VERB	Dislike	Negative
aggravate	VERB	Dislike	Negative
exacerbate	VERB	Dislike	Negative
exasperation	NOUN	Dislike	Negative
aggravation	NOUN	Dislike	Negative
provoked	ADJ	Dislike	Negative
aggravated	ADJ	Dislike	Negative
disgusted	ADJ	Dislike	Negative
yucky	ADJ	Dislike	Negative
disgusting	ADJ	Dislike	Negative
foul	ADJ	Dislike	Negative
loathly	ADJ	Dislike	Negative
repellant	ADJ	Dislike	Negative
distasteful	ADJ	Dislike	Negative
repellent	ADJ	Dislike	Negative
revolting	ADJ	Dislike	Negative
wicked	ADJ	Dislike	Negative
disgustful	ADJ	Dislike	Negative
disgustedly	ADV	Dislike	Negative
disgustingly	ADV	Dislike	Negative
revoltingly	ADV	Dislike	Negative
sickeningly	ADV	Dislike	Negative
distastefully	ADV	Dislike	Negative
disgust	NOUN	Dislike	Negative
grasping	ADJ	Dislike	Negative
avaricious	ADJ	Dislike	Negative
prehensile	ADJ	Dislike	Negative
greedy	ADJ	Dislike	Negative
grabby	ADJ	Dislike	Negative
covetousness	NOUN	Dislike	Negative
covet	VERB	Dislike	Negative
vindictiveness	NOUN	Dislike	Negative
vengefulness	NOUN	Dislike	Negative
vindictive	ADJ	Dislike	Negative
despiteful	ADJ	Dislike	Negative
spiteful	ADJ	Dislike	Negative
vindictively	ADV	Dislike	Negative
revengefully	ADV	Dislike	Negative
vengefully	ADV	Dislike	Negative
offend	VERB	Dislike	Negative
pique	VERB	Dislike	Negative
pique	NOUN	Dislike	Negative
temper	NOUN	Dislike	Negative
irritation	NOUN	Dislike	Negative
incensed	ADJ	Dislike	Negative
indignant	ADJ	Dislike	Negative
outraged	ADJ	Dislike	Negative
umbrageous	ADJ	Dislike	Negative
offense	NOUN	Dislike	Negative
umbrage	NOUN	Dislike	Negative
maddening	ADJ	Dislike	Negative
exasperating	ADJ	Dislike	Negative
infuriating	ADJ	Dislike	Negative
incense	VERB	Dislike	Negative
outrage	VERB	Dislike	Negative
enfuriate	VERB	Dislike	Negative
infuriate	VERB	Dislike	Negative
furiously	ADV	Dislike	Negative
fury	NOUN	Dislike	Negative
rage	NOUN	Dislike	Negative
madness	NOUN	Dislike	Negative
frustration	NOUN	Dislike	Negative
discouraged	ADJ	Dislike	Negative
baffled	ADJ	Dislike	Negative
balked	ADJ	Dislike	Negative
frustrated	ADJ	Dislike	Negative
torment	VERB	Dislike	Negative
bedevil	VERB	Dislike	Negative
frustrate	VERB	Dislike	Negative
crucify	VERB	Dislike	Negative
dun	VERB	Dislike	Negative
tantalize	VERB	Dislike	Negative
frustrating	ADJ	Dislike	Negative
misopedia	NOUN	Dislike	Negative
enragement	NOUN	Dislike	Negative
infuriation	NOUN	Dislike	Negative
outrage	NOUN	Dislike	Negative
indignation	NOUN	Dislike	Negative
indignantly	ADV	Dislike	Negative
murderousness	NOUN	Dislike	Negative
amok	ADV	Dislike	Negative
murderously	ADV	Dislike	Negative
amuck	ADV	Dislike	Negative
scorn	VERB	Dislike	Negative
despise	VERB	Dislike	Negative
contemn	VERB	Dislike	Negative
disdain	VERB	Dislike	Negative
scorn	NOUN	Dislike	Negative
disdain	NOUN	Dislike	Negative
contempt	NOUN	Dislike	Negative
antagonism	NOUN	Dislike	Negative
misocainea	NOUN	Dislike	Negative
inimical	ADJ	Dislike	Negative
unfriendly	ADJ	Dislike	Negative
unfriendliness	NOUN	Dislike	Negative
grudge	VERB	Dislike	Negative
grievance	NOUN	Dislike	Negative
score	NOUN	Dislike	Negative
grudge	NOUN	Dislike	Negative
disapproving	ADJ	Dislike	Negative
reject	VERB	Dislike	Negative
disapprove	VERB	Dislike	Negative
disapproval	NOUN	Dislike	Negative
discouraging	ADJ	Dislike	Negative
despisal	NOUN	Dislike	Negative
despising	NOUN	Dislike	Negative
maleficence	NOUN	Dislike	Negative
evil	ADJ	Dislike	Negative
malefic	ADJ	Dislike	Negative
malign	ADJ	Dislike	Negative
ungratefulness	NOUN	Ingratitude	Negative
ingratitude	NOUN	Ingratitude	Negative
bashfulness	NOUN	Shame	Negative
abashment	NOUN	Shame	Negative
self-conscious	ADJ	Shame	Negative
self-consciously	ADV	Shame	Negative
self-consciousness	NOUN	Shame	Negative
uncomfortableness	NOUN	Shame	Negative
uneasiness	NOUN	Shame	Negative
disconcertion	NOUN	Shame	Negative
discomfiture	NOUN	Shame	Negative
discomposure	NOUN	Shame	Negative
disconcertment	NOUN	Shame	Negative
embarrassed	ADJ	Shame	Negative
discomfited	ADJ	Shame	Negative
upset	VERB	Shame	Negative
disconcert	VERB	Shame	Negative
untune	VERB	Shame	Negative
discompose	VERB	Shame	Negative
discomfit	VERB	Shame	Negative
mortification	NOUN	Shame	Negative
chagrin	NOUN	Shame	Negative
humiliation	NOUN	Shame	Negative
mortify	VERB	Shame	Negative
humble	VERB	Shame	Negative
abase	VERB	Shame	Negative
humiliate	VERB	Shame	Negative
chagrin	VERB	Shame	Negative
abashed	ADJ	Shame	Negative
chagrined	ADJ	Shame	Negative
shamefacedness	NOUN	Shame	Negative
sheepishness	NOUN	Shame	Negative
hangdog	ADJ	Shame	Negative
guilty	ADJ	Shame	Negative
shamefaced	ADJ	Shame	Negative
shamed	ADJ	Shame	Negative
sheepish	ADJ	Shame	Negative
shamefacedly	ADV	Shame	Negative
consternate	VERB	Shame	Negative
flurry	VERB	Shame	Negative
confuse	VERB	Shame	Negative
confusedly	ADV	Shame	Negative
discombobulation	NOUN	Shame	Negative
confusion	NOUN	Shame	Negative
disordered	ADJ	Shame	Negative
upset	ADJ	Shame	Negative
confused	ADJ	Shame	Negative
broken	ADJ	Shame	Negative
confusing	ADJ	Shame	Negative
self-hatred	NOUN	Shame	Negative
self-disgust	NOUN	Shame	Negative
conscience	NOUN	Shame	Negative
embarrassingly	ADV	Shame	Negative
mortified	ADJ	Shame	Negative
humiliated	ADJ	Shame	Negative
sticky	ADJ	Shame	Negative
unenviable	ADJ	Shame	Negative
embarrassing	ADJ	Shame	Negative
awkward	ADJ	Shame	Negative
embarrassment	NOUN	Shame	Negative
mortifying	ADJ	Shame	Negative
abash	VERB	Shame	Negative
embarrass	VERB	Shame	Negative
shame	VERB	Shame	Negative
black	ADJ	Shame	Negative
disgraceful	ADJ	Shame	Negative
opprobrious	ADJ	Shame	Negative
ignominious	ADJ	Shame	Negative
shameful	ADJ	Shame	Negative
inglorious	ADJ	Shame	Negative
scandalous	ADJ	Shame	Negative
shocking	ADJ	Shame	Negative
dishonourably	ADV	Shame	Negative
shamefully	ADV	Shame	Negative
disgracefully	ADV	Shame	Negative
dishonorably	ADV	Shame	Negative
ignominiously	ADV	Shame	Negative
ingloriously	ADV	Shame	Negative
discreditably	ADV	Shame	Negative
shame	NOUN	Shame	Negative
ashamed	ADJ	Shame	Negative
dishonored	ADJ	Shame	Negative
disgraced	ADJ	Shame	Negative
discredited	ADJ	Shame	Negative
forgiveness	NOUN	Compassion	Negative
excusable	ADJ	Compassion	Negative
forgivable	ADJ	Compassion	Negative
venial	ADJ	Compassion	Negative
forgive	VERB	Compassion	Negative
merciful	ADJ	Compassion	Negative
mercifulness	NOUN	Compassion	Negative
mercy	NOUN	Compassion	Negative
mercifully	ADV	Compassion	Negative
pathos	NOUN	Compassion	Negative
commiseration	NOUN	Compassion	Negative
ruth	NOUN	Compassion	Negative
pity	NOUN	Compassion	Negative
sympathize	VERB	Compassion	Negative
commiserate	VERB	Compassion	Negative
compassionate	VERB	Compassion	Negative
pity	VERB	Compassion	Negative
compassionateness	NOUN	Compassion	Negative
compassion	NOUN	Compassion	Negative
compassionate	ADJ	Compassion	Negative
tenderheartedness	NOUN	Compassion	Negative
tenderness	NOUN	Compassion	Negative
lovesome	ADJ	Compassion	Negative
caring	ADJ	Compassion	Negative
tender	ADJ	Compassion	Negative
warm	ADJ	Compassion	Negative
fond	ADJ	Compassion	Negative
affectionate	ADJ	Compassion	Negative
tenderly	ADV	Compassion	Negative
self-deprecating	ADJ	Humility	Negative
self-depreciation	NOUN	Humility	Negative
meekness	NOUN	Humility	Negative
humbling	ADJ	Humility	Negative
demeaning	ADJ	Humility	Negative
humiliating	ADJ	Humility	Negative
mortifying	ADJ	Humility	Negative
embarrassed	ADJ	Humility	Negative
mortified	ADJ	Humility	Negative
humiliated	ADJ	Humility	Negative
humiliatingly	ADV	Humility	Negative
demeaningly	ADV	Humility	Negative
humility	NOUN	Humility	Negative
humbleness	NOUN	Humility	Negative
mortify	VERB	Humility	Negative
humble	VERB	Humility	Negative
abase	VERB	Humility	Negative
humiliate	VERB	Humility	Negative
chagrin	VERB	Humility	Negative
intimidation	NOUN	Despair	Negative
pessimistic	ADJ	Despair	Negative
pessimism	NOUN	Despair	Negative
pessimistically	ADV	Despair	Negative
discomfited	ADJ	Despair	Negative
foiled	ADJ	Despair	Negative
disappointed	ADJ	Despair	Negative
thwarted	ADJ	Despair	Negative
frustrated	ADJ	Despair	Negative
defeated	ADJ	Despair	Negative
defeatism	NOUN	Despair	Negative
defeat	VERB	Despair	Negative
overcome	VERB	Despair	Negative
misanthropic	ADJ	Despair	Negative
misanthropical	ADJ	Despair	Negative
cynical	ADJ	Despair	Negative
cynicism	NOUN	Despair	Negative
despair	VERB	Despair	Negative
desperate	ADJ	Despair	Negative
despairing	ADJ	Despair	Negative
despairingly	ADV	Despair	Negative
despondently	ADV	Despair	Negative
despair	NOUN	Despair	Negative
hopelessness	NOUN	Despair	Negative
hopelessly	ADV	Despair	Negative
dispiritedly	ADV	Despair	Negative
hopeless	ADJ	Despair	Negative
abject	ADJ	Despair	Negative
resigned	ADJ	Despair	Negative
unhopeful	ADJ	Despair	Negative
resignedly	ADV	Despair	Negative
abjectly	ADV	Despair	Negative
surrender	NOUN	Despair	Negative
resignation	NOUN	Despair	Negative
resign	VERB	Despair	Negative
submit	VERB	Despair	Negative
reconcile	VERB	Despair	Negative
disheartenment	NOUN	Despair	Negative
dismay	NOUN	Despair	Negative
discouragement	NOUN	Despair	Negative
discouraged	ADJ	Despair	Negative
baffled	ADJ	Despair	Negative
balked	ADJ	Despair	Negative
discourage	VERB	Despair	Negative
discouraging	ADJ	Despair	Negative
demoralized	ADJ	Despair	Negative
disheartened	ADJ	Despair	Negative
fidgetiness	NOUN	Anxiety	Negative
fidget	NOUN	Anxiety	Negative
restlessness	NOUN	Anxiety	Negative
itchy	ADJ	Anxiety	Negative
restless	ADJ	Anxiety	Negative
fretful	ADJ	Anxiety	Negative
fidgety	ADJ	Anxiety	Negative
solicitous	ADJ	Anxiety	Negative
solicitously	ADV	Anxiety	Negative
solicitude	NOUN	Anxiety	Negative
solicitousness	NOUN	Anxiety	Negative
jittery	ADJ	Anxiety	Negative
nervy	ADJ	Anxiety	Negative
uptight	ADJ	Anxiety	Negative
jumpy	ADJ	Anxiety	Negative
edgy	ADJ	Anxiety	Negative
high-strung	ADJ	Anxiety	Negative
nervous	ADJ	Anxiety	Negative
overstrung	ADJ	Anxiety	Negative
restive	ADJ	Anxiety	Negative
inquietude	NOUN	Anxiety	Negative
disquietude	NOUN	Anxiety	Negative
uneasiness	NOUN	Anxiety	Negative
edginess	NOUN	Anxiety	Negative
jitteriness	NOUN	Anxiety	Negative
nervousness	NOUN	Anxiety	Negative
restiveness	NOUN	Anxiety	Negative
jumpiness	NOUN	Anxiety	Negative
sinking	NOUN	Anxiety	Negative
qualm	NOUN	Anxiety	Negative
scruple	NOUN	Anxiety	Negative
misgiving	NOUN	Anxiety	Negative
impatience	NOUN	Anxiety	Negative
impatiently	ADV	Anxiety	Negative
raring	ADJ	Anxiety	Negative
impatient	ADJ	Anxiety	Negative
afraid	ADJ	Anxiety	Negative
dysphoric	ADJ	Anxiety	Negative
unhappy	ADJ	Anxiety	Negative
distressed	ADJ	Anxiety	Negative
distress	VERB	Anxiety	Negative
distressfully	ADV	Anxiety	Negative
worryingly	ADV	Anxiety	Negative
distress	NOUN	Anxiety	Negative
trouble	NOUN	Anxiety	Negative
worry	NOUN	Anxiety	Negative
upset	ADJ	Anxiety	Negative
disturbed	ADJ	Anxiety	Negative
disquieted	ADJ	Anxiety	Negative
worried	ADJ	Anxiety	Negative
worrying	ADJ	Anxiety	Negative
distressing	ADJ	Anxiety	Negative
troubling	ADJ	Anxiety	Negative
perturbing	ADJ	Anxiety	Negative
disturbing	ADJ	Anxiety	Negative
distressful	ADJ	Anxiety	Negative
worrisome	ADJ	Anxiety	Negative
dwell	VERB	Anxiety	Negative
brood	VERB	Anxiety	Negative
worry	VERB	Anxiety	Negative
distressingly	ADV	Anxiety	Negative
painfully	ADV	Anxiety	Negative
disconcertion	NOUN	Anxiety	Negative
discomfiture	NOUN	Anxiety	Negative
discomposure	NOUN	Anxiety	Negative
disconcertment	NOUN	Anxiety	Negative
embarrassed	ADJ	Anxiety	Negative
discomfited	ADJ	Anxiety	Negative
upset	VERB	Anxiety	Negative
disconcert	VERB	Anxiety	Negative
untune	VERB	Anxiety	Negative
discompose	VERB	Anxiety	Negative
discomfit	VERB	Anxiety	Negative
insecurely	ADV	Anxiety	Negative
insecurity	NOUN	Anxiety	Negative
insecure	ADJ	Anxiety	Negative
anxiousness	NOUN	Anxiety	Negative
disquiet	NOUN	Anxiety	Negative
anxiously	ADV	Anxiety	Negative
uneasily	ADV	Anxiety	Negative
apprehensively	ADV	Anxiety	Negative
apprehensive	ADJ	Anxiety	Negative
anxious	ADJ	Anxiety	Negative
unquiet	ADJ	Anxiety	Negative
uneasy	ADJ	Anxiety	Negative
stewing	NOUN	Anxiety	Negative
tumult	NOUN	Anxiety	Negative
turmoil	NOUN	Anxiety	Negative
concerned	ADJ	Anxiety	Negative
care	NOUN	Anxiety	Negative
concern	NOUN	Anxiety	Negative
fear	NOUN	Anxiety	Negative
interest	VERB	Anxiety	Negative
occupy	VERB	Anxiety	Negative
concern	VERB	Anxiety	Negative
anxiety	NOUN	Anxiety	Negative
angst	NOUN	Anxiety	Negative
fulgurous	ADJ	Daze	Negative
dazzling	ADJ	Daze	Negative
fulgurant	ADJ	Daze	Negative
stun	VERB	Daze	Negative
daze	VERB	Daze	Negative
bedaze	VERB	Daze	Negative
stupefied	ADJ	Daze	Negative
stunned	ADJ	Daze	Negative
stupid	ADJ	Daze	Negative
dazed	ADJ	Daze	Negative
dazzlingly	ADV	Daze	Negative
stupor	NOUN	Daze	Negative
shock	NOUN	Daze	Negative
daze	NOUN	Daze	Negative
apathy	NOUN	Apathy	Neutral
apathetically	ADV	Apathy	Neutral
apathetic	ADJ	Apathy	Neutral
emotionless	ADJ	Apathy	Neutral
passionless	ADJ	Apathy	Neutral
impassivity	NOUN	Apathy	Neutral
unemotionality	NOUN	Apathy	Neutral
impassiveness	NOUN	Apathy	Neutral
emotionlessness	NOUN	Apathy	Neutral
indifference	NOUN	Apathy	Neutral
stolidity	NOUN	Apathy	Neutral
phlegm	NOUN	Apathy	Neutral
listlessness	NOUN	Apathy	Neutral
lassitude	NOUN	Apathy	Neutral
languor	NOUN	Apathy	Neutral
languid	ADJ	Apathy	Neutral
languorous	ADJ	Apathy	Neutral
dreamy	ADJ	Apathy	Neutral
lackadaisical	ADJ	Apathy	Neutral
languorously	ADV	Apathy	Neutral
unconcerned	ADJ	Unconcern	Neutral
unconcern	NOUN	Unconcern	Neutral
unconcernedly	ADV	Unconcern	Neutral
detachment	NOUN	Unconcern	Neutral
withdrawal	NOUN	Unconcern	Neutral
indifferently	ADV	Unconcern	Neutral
indifference	NOUN	Unconcern	Neutral
indifferent	ADJ	Unconcern	Neutral
apathetic	ADJ	Unconcern	Neutral
distance	VERB	Unconcern	Neutral
aloofness	NOUN	Unconcern	Neutral
distance	NOUN	Unconcern	Neutral
earnest	ADJ	Gravity	Ambiguous
heartfelt	ADJ	Gravity	Ambiguous
devout	ADJ	Gravity	Ambiguous
dear	ADJ	Gravity	Ambiguous
seriousness	NOUN	Gravity	Ambiguous
earnestness	NOUN	Gravity	Ambiguous
sincerity	NOUN	Gravity	Ambiguous
earnestly	ADV	Gravity	Ambiguous
seriously	ADV	Gravity	Ambiguous
solemnity	NOUN	Gravity	Ambiguous
gravity	NOUN	Gravity	Ambiguous
surprisedly	ADV	Surprise	Ambiguous
surprise	VERB	Surprise	Ambiguous
astonishingly	ADV	Surprise	Ambiguous
amazingly	ADV	Surprise	Ambiguous
surprisingly	ADV	Surprise	Ambiguous
surprising	ADJ	Surprise	Ambiguous
surprise	NOUN	Surprise	Ambiguous
surprised	ADJ	Surprise	Ambiguous
electricity	NOUN	Agitation	Ambiguous
electrifying	ADJ	Agitation	Ambiguous
thrilling	ADJ	Agitation	Ambiguous
inflame	VERB	Agitation	Ambiguous
ignite	VERB	Agitation	Ambiguous
heat	VERB	Agitation	Ambiguous
touch	VERB	Agitation	Ambiguous
stir	VERB	Agitation	Ambiguous
shake	VERB	Agitation	Ambiguous
excite	VERB	Agitation	Ambiguous
stimulate	VERB	Agitation	Ambiguous
stir	NOUN	Agitation	Ambiguous
instigate	VERB	Agitation	Ambiguous
incite	VERB	Agitation	Ambiguous
sensationally	ADV	Agitation	Ambiguous
sensational	ADJ	Agitation	Ambiguous
sensationalistic	ADJ	Agitation	Ambiguous
yellow	ADJ	Agitation	Ambiguous
scandalmongering	ADJ	Agitation	Ambiguous
sensation	NOUN	Agitation	Ambiguous
unrest	NOUN	Agitation	Ambiguous
tumult	NOUN	Agitation	Ambiguous
turmoil	NOUN	Agitation	Ambiguous
agitation	NOUN	Agitation	Ambiguous
agitated	ADJ	Agitation	Ambiguous
agitate	VERB	Agitation	Ambiguous
foment	VERB	Agitation	Ambiguous
reverentially	ADV	Fear	Ambiguous
reverently	ADV	Fear	Ambiguous
idolize	VERB	Fear	Ambiguous
revere	VERB	Fear	Ambiguous
hero-worship	VERB	Fear	Ambiguous
worship	VERB	Fear	Ambiguous
veneration	NOUN	Fear	Ambiguous
awe	NOUN	Fear	Ambiguous
reverence	NOUN	Fear	Ambiguous
venerate	VERB	Fear	Ambiguous
reverence	VERB	Fear	Ambiguous
fear	VERB	Fear	Ambiguous
reverent	ADJ	Fear	Ambiguous
wistful	ADJ	Pensiveness	Ambiguous
pensive	ADJ	Pensiveness	Ambiguous
brooding	NOUN	Pensiveness	Ambiguous
pensiveness	NOUN	Pensiveness	Ambiguous
contemplative	ADJ	Pensiveness	Ambiguous
reflective	ADJ	Pensiveness	Ambiguous
broody	ADJ	Pensiveness	Ambiguous
brooding	ADJ	Pensiveness	Ambiguous
ruminative	ADJ	Pensiveness	Ambiguous
musing	ADJ	Pensiveness	Ambiguous
meditative	ADJ	Pensiveness	Ambiguous
pondering	ADJ	Pensiveness	Ambiguous
pensively	ADV	Pensiveness	Ambiguous
hopeful	ADJ	Expectation	Ambiguous
hopefully	ADV	Expectation	Ambiguous
desire	VERB	Expectation	Ambiguous
hope	VERB	Expectation	Ambiguous
trust	VERB	Expectation	Ambiguous
hope	NOUN	Expectation	Ambiguous
fever	NOUN	Expectation	Ambiguous
feverishly	ADV	Expectation	Ambiguous
fevered	ADJ	Expectation	Ambiguous
hectic	ADJ	Expectation	Ambiguous
feverish	ADJ	Expectation	Ambiguous
expectant	ADJ	Expectation	Ambiguous
anticipant	ADJ	Expectation	Ambiguous
anticipative	ADJ	Expectation	Ambiguous
expectation	NOUN	Expectation	Ambiguous
anticipate	VERB	Expectation	Ambiguous
expect	VERB	Expectation	Ambiguous
expectantly	ADV	Expectation	Ambiguous
